{
    "height": 10,
    "width": 10,
    "layers": {
        "ground": [
            [0, 1, 1, 1, 0, 0, 0, 0, 0, 0],
            [0, 1, 0, 0, 0, 0, 0, 0, 0, 0],
            [0, 1, 0, 0, 0, 2, 2, 2, 2, 0],
            [0, 1, 0, 0, 0, 0, 0, 0, 0, 0],
            [0, 1, 0, 0, 0, 0, 0, 0, 0, 0],
            [0, 1, 0, 0, 1, 1, 1, 0, 0, 0],
            [0, 0, 0, 0, 0, 0, 1, 0, 0, 0],
            [0, 0, 0, 0, 0, 0, 1, 0, 0, 0],
            [0, 0, 0, 0, 0, 0, 0, 0, 0, 0],
            [0, 1, 1, 0, 0, 0, 0, 0, 0, 0]
        ],
        "objects": [
            [0, 0, 0, 0, 5, 0, 0, 0, 0, 0],
            [0, 0, 0, 0, 0, 0, 0, 0, 0, 0],
            [0, 0, 0, 9, 0, 0, 0, 0, 0, 0],
            [0, 0, 0, 0, 0, 0, 0, 0, 0, 0],
            [0, 0, 0, 0, 6, 0, 0, 0, 0, 0],
            [0, 0, 0, 0, 0, 0, 0, 0, 0, 0],
            [0, 0, 0, 0, 0, 0, 0, 0, 0, 0],
            [0, 0, 0, 0, 0, 0, 0, 0, 0, 0],
            [0, 0, 0, 0, 0, 0, 0, 0, 0, 0],
            [0, 0, 0, 0, 0, 0, 0, 0, 0, 0]
        ]
    },
    "entities": [
        { "type": "spawn_point", "x": 5, "y": 7}
    ]

}